NO ./textures/North.xpm
SO ./textures/South.xpm
WE ./textures/West.xpm
EA ./textures/East.xpm

F 0,53,53
C 50,30,50

1111111111111111111111111
1000000000110010000010001
1011000001110010010000001
1001001000000100000000001
10111111101100000111000001
10000000001100000111011111111
11110111111111011100000010001
11110111111111011101010010001
11000000110101011100010000001
10010000000000001100000010001
1000000100N001000001010010001
11000001110101011111011110001
11110111 1110101 101111010001
11111111 1111111 111111111111