NO ./textures/north.xpm
SO ./textures/south.xpm
WE ./textures/west.xpm
EA ./textures/east.xpm
F 50,50,50
C 100,150,200

11111111111
10000000001
10000W00001
10000000001
11111111111
