NO ./textures/north.xpm
SO ./textures/south.xpm
WE ./textures/west.xpm
EA ./textures/east.xpm
F 0,128,0
C 135,206,235

        11111111111111
        10000000000001
        10110000111001
        10010000000001
11111111110000001111111
10000000110000001000001
10111011111110110111101
100000000000000000E0001
10111111111111111111101
10000000000000000000001
11111111111111111111111
